0 0 0 0 0 0 0 0 0 0 0 0 0 0 0 0 0 0 0 0
0 0 0 0 0 0 0 0 0 0 0 0 0 0 0 0 0 0 0 0
0 0 0 0 0 0 0 0 0 0 0 0 0 0 0 0 0 0 0 0
0 0 0 1 1 1 1 1 1 2 0 0 1 1 1 1 1 1 1 5
0 0 0 3 0 0 0 0 0 2 0 0 3 0 0 0 0 0 0 0
0 0 0 3 0 0 2 4 4 4 0 0 3 0 0 0 0 0 0 0
0 0 0 3 0 0 2 0 0 0 0 0 3 0 0 0 0 0 0 0
0 0 0 3 0 0 2 0 0 0 0 0 3 0 0 0 0 0 0 0
0 0 0 3 0 0 2 0 0 0 0 0 3 0 0 0 0 0 0 0
1 1 1 3 0 0 1 1 1 1 1 1 3 0 0 0 0 0 0 0
0 0 0 0 0 0 0 0 0 0 0 0 0 0 0 0 0 0 0 0
0 0 0 0 0 0 0 0 0 0 0 0 0 0 0 0 0 0 0 0
0 0 0 0 0 0 0 0 0 0 0 0 0 0 0 0 0 0 0 0